

NO img/redbrick.xpm

SO img/redbrick.xpm

WE       img/redbrick.xpm
EA img/redbrick.xpm

F 42,42,42

C 240,240,242

 111111
11010101
100000001
1000N0001
100000001
110000011
110000011
110000011
  11111
