

NO img/N.xpm

SO img/S.xpm

WE       img/W.xpm
EA img/E.xpm

F 0,0,0

C 240,240,242

 111111
100000011
100000001
1000N0001
100000001
110000111
  11111
