

NO ./path_to_the_north_texture

SO ./path_to_the_south_texture

WE       ./path_to_the_west_texture
EA ./path_to_the_east_texture

F 0,0,0

C 255,255,255

 111111
100000011
100000001
1000N0001
100000001
110000111
  11111
