

NO     img/aproust.xpm

SO img/man.xpm

     WE       img/redbrick.xpm


C 240,240,240
F 69,69,69

EA img/freddy.xpm


 111111
11000001
100000001
1000N0001
100000001
100000011
110000011
110000011
110000011
110000011
110000011
110000011
110000011
110000011
110000011
110000011
110000011
110000011
110000011
110000011
110000011
110000011
110000011
110000011
110000011
110000011
110000011
110000011
110000011
110000011
  11111
