

NO img/N.xpm

SO img/S.xpm
F 69,69,69

WE       img/redbrick.xpm
EA img/E.xpm


C 240,240,240

 111111
11000001
100000001
1000N0001
100000001
100000011
110000011
110000011
110000011
110000011
  11111
