

NO ./path_to_the_north_texture

SO ./path_to_the_south_texture

WE       ./path_to_the_west_texture
EA ./path_to_the_east_texture

F 0,0,0

C 255,255,255

11111
100011
10N001
100011
11111
